{
    "H" : 7,
    "W" : 7,
    "EndX" : 3,
    "EndY" : 1,
    "BG" : [["X", "X", "X", "X", "X", "X", "X"],
            ["X", ".", ".", ".", ".", ".", "X"],
            ["X", ".", ".", ".", ".", ".", "X"],
            ["X", "X", "X", ".", "X", "X", "X"],
            ["X", ".", ".", ".", ".", ".", "X"],
            ["X", ".", ".", ".", ".", ".", "X"],
            ["X", "X", "X", "X", "X", "X", "X"]]
}