{
    "H" : 8,
    "W" : 7,
    "EndX" : 5,
    "EndY" : 1,
    "BG" : [["X", "X", "X", "X", "X", "X", "X"],
            ["X", ".", ".", ".", ".", ".", "X"],
            ["X", ".", ".", ".", ".", ".", "X"],
            ["X", ".", ".", ".", ".", ".", "X"],
            ["X", ".", ".", ".", ".", ".", "X"],
            ["X", ".", ".", ".", ".", ".", "X"],
            ["X", ".", ".", ".", ".", ".", "X"],
            ["X", "X", "X", "X", "X", "X", "X"]]
}